Version:1
........
..1111..
..1111..
........
..2222..
..2222..

