Version:1
........
..1111..
..1141..
...3....
..2222..
..2222..
